00000000020000000000
01110111111111111110
01111111000011101110
01110101011011101110
01110101011011101110
01111101111011101110
01111100000111111110
01111111110000111110
01111111111110111110
21100000011110111112
01111111011110111110
01100000000000111110
01111111101101101110
01111111101111111110
01000001101110000110
01111111101111111110
01110000001111111110
01111111101111111110
01111111111111111110
00000000200000000000